...........
...Y...Y...
...........
...X.X.Y...
.....W.....
.X.L.X.X.Y.
...........
.L.L.X.....
...........
.L.........
...........
10
