.......W.....
...H.Y.X.X.G.
.............
.......X.....
.............
.Y.X.L.P.....
.............
.....Y.Y.....
.......W.....
7