...........
.....Y.....
.....W.....
.....X.X.YW
...........
.....X.....
...........
.P.X.H.P...
...........
...X.......
...........
...Y.......
...W.......
8
