.........
...X.....
.........
...Y.....
.........
...X.X.L.
.........
.HWP.XWY.
.........
.Y.X.XW..
.........
10