.........
WX.X.Y...
.........
...Y.....
.........
.L.X.X.LW
.........
8