.............                                      
...P.Y.Y.Y.P.
.............
...X.........
.............
.G.L.X.......
.....W.......
.....Y.......
.............
6