.........
.......Y.
.........
.P.X.S.X.
.........
.....X...
.........
.....X...
.........
.....Y...
.....W...
4