.........
.P.X.XW..
.......W.
.XWY.Y.X.
.........
.XWX.YWX.
...W.....
.P.X.X.PW
.....W...
11
