...........
.P.......Y.
...........
.X.......X.
...........
.X.X.X.Y.X.
...........
.X.X.X.....
...........
.....L.....
.....W.....
11