...............
.....G.........
.....W.........
.B.P.X.Y.L.Y.Y.
.......W.......
.......Y.......
...............
6