.........
.....B...
.........
.....Y...
.........
.......Y.
.........
.....YWY.
.........
.L.G.G.Y.
.........
...G.G.Y.
.........
10