...........
.....Y.....
...........
...........
...........
...X.Y.Y.L.
...........
...X.......
...........
.X.L.X.H...
...........
7
