...........
.....X.L.L.
...........
.....Y.X...
...........
.L.X.X.X...
...........
...X.X.X...
...........
.Y.Y.L.Y...
...........
9