.........
.......P.
.........
.......X.
.........
.......Y.
.........
WX.X.X.G.
.........
.X.....X.
.........
.X.......
.........
.Y.......
.W.......
5