.........
.....Y...
.........
.....P...
.........
WY.X.X...
.........
.....S.Y.
.........
.....G...
.........
5