...........
.Y.B.....X.
...........
...........
...........
...........
...........
.YWX.L.Y.B.
...........
7
