.........W.
WY.X.X.X.X.
...........
.........G.
...........
.....P.X.XW
...........
.........Y.
...........
4