...............
.........Y.....
...W.....W.....
...X.Y.Y.L.....
...............
.X.B.X.X.X.PWY.
...............
.....H...X.....
...............
13