...........
...P.X.X.B.
...........
...Y.....Y.
...........
...X.......
...........
.S.X.Y.....
...........
...X.......
...........
8