.............
.......G.....
.......W.....
...L.X.X.X.Y.
.......W.....
WY.X.X.X.P.Y.
.......W.....
...L...Y.....
.............
7