...........
.....Y.....
...........
.L.X.X.X.Y.
...........
...G.XWY...
...........
.....L.....
...........
5