.........
.P.......
.........
.X.......
.........
.Y...Y...
.........
WX.X.P.YW
.........
.....G...
.........
4