...........
.....H.X.H.
...........
...........
...........
.....L.....
...........
.Y.X.X...Y.
...........
.Y.X.L.....
...........
.Y.X.X.....
...........
8