.W.......
.Y.......
.........
.X.......
.........
.P.Y.X.P.
.........
.......Y.
.........
.......X.
.........
.......P.
.........
3