.........
.P.X.XW..
.........
.....P...
.........
.....Y...
.........
.....S.Y.
.........
.....Y...
.....W...
4