.....W.W...
.....P.Y.YW
...........
.....YWP...
...........
.....X.X...
...........
.....X.X...
...........
.P.Y.X.XW..
...........
.P.X.X.X...
.......W...
8