.........
.G.X.....
.........
...X.....
...W.....
...XWX.X.
.......W.
.....XWY.
.........
6