.....W.....
.....Y.....
...........
.....X.....
...........
.P.X.Y.XWY.
...........
.....G.....
...........
.....G.....
...........
6