...........
.P.Y.X.Y.P.
...........
.X.........
...........
.Y.Y.......
...........
.P.S.B.G...
.W...W.....
.Y...Y.....
...........
10