.............
.....P.......
.............
.....P...Y...
.........W...
WX.X.Y.X.X.P.
.............
.X...Y.......
.............
.Y...X.......
.............
.H...X.......
.............
9