...............
.......P.......
...............
.......X.......
...............
.......Y.......
...............
.B.H.Y.Y.Y.Y.P.
...............
.......Y.......
...............
.......L.......
...............
.......G.......
...............
7