.........
...Y.X.Y.
.........
.Y.Y.X...
.........
.G.L.X...
.........
...P.L...
.........
8