...........
...G.Y.X.X.
...W.......
...X.....B.
...........
.Y.Y.L.LWL.
...........
...X.......
...........
...X.X.Y...
...........
...Y.......
...........
9