.............
.........P...
.............
.........H...
.............
.........X...
.............
WY.X.G.P.X...
.............
.Y...X...XWY.
.............
.Y...........
.W...........
10