...........
.......Y...
...........
.......Y.Y.
...........
.......Y...
...........
.G.G.G.Y...
...........
.G.....Y...
...........
.G.........
...........
.G.........
...........
16