.............
.......P.....
.............
.......Y.....
.............
.B.Y.S.Y.Y.H.
.............
.......Y.....
.............
.......P.....
.............
6