...........
.....G.G.G.
...........
.....G.G.G.
...........
.Y.Y.X.G.G.
...........
.Y.Y.Y.....
...........
.Y.Y.Y.....
...........
19