...........
.....X.Y.Y.
...........
.....G.S.Y.
...........
.H...X.Y.Y.
...........
...........
...........
.H...H.....
...........
8