...........
.....H.X.Y.
...........
...........
...........
...Y.Y.X...
...........
...X.Y.X...
...........
.P.L.X.L...
...........
9