.............
.....Y.......
.............
.....X.......
.............
.Y.Y.X.L.L.L.
.............
.......X.....
.............
.....Y.X.G...
.............
9