...............
.......Y.....Y.
.......W.......
.......X.X.Y.X.
...............
.....G.X.....S.
...............
.......X.......
...............
.Y.X.X.X.L.P...
...............
9