...........
.......P...
...........
.......P...
...........
.......P...
...........
.......Y...
...........
.X...S.B.Y.
...........
.Y.....Y...
...........
WY.X.X.X...
.......W...
10