.........
.......Y.
.........
.X...Y.X.
.........
.B.....S.
.........
.........
.........
.X.Y.X.P.
.........
.X.Y.X.P.
.........
11
