...........
.........Y.
...........
.........Y.
...........
.L.X.L...Y.
...........
.X.X.X.Y.Y.
...........
.H.X.L...G.
...........
13