...........
.....Y.....
...........
.P...Y.....
...........
.H...L.X.X.
...........
.Y.........
...........
.H.X.X.Y...
...........
6