.......W...
.....Y.X.XW
...........
.......X...
...........
.......X...
...........
.X.X.L.L...
.....W.....
.Y.X.X.....
...........
.X.X.X.....
...........
9