...........
.B...X.X.Y.
...........
.....S.B.Y.
...........
...........
...........
.Y.........
...........
.B.....Y...
...........
8