.W.........
.Y.........
...........
.X.........
...........
.X.....P...
...........
WX.X.X.Y...
...........
.......GWY.
...........
.......G...
...........
5