.........
.L.X.X...
.........
...Y.X.X.
.........
.....X.X.
.........
...L.X.X.
.........
.Y.X.X...
.........
7