...........
.......Y...
...........
.......H...
...........
.......X...
.......W...
.H.X.S.X.Y.
...........
.......Y...
...........
5