...........
.......Y...
.......W...
...P.X.XW..
...W.W.....
WY.X.X.X...
.......W...
.......S.Y.
...........
.......G...
...........
6