...........
.....B.....
...........
.....G.G...
...........
.Y.Y.G.G.B.
...........
.Y.S.Y.....
...........
.Y.Y.Y.....
...........
11