.............
...X.........
.............
...X.X.Y.X.G.
.....W.......
.Y.L.S...X...
.............
...Y.....X...
.............
...P.....Y...
.........W...
9