...............
.......X.X.Y...
...............
...L...Y.......
...............
...X...X.......
...............
.Y.B.X.Y.B.X.G.
...............
7