...........
...Y.......
...........
.YWXWG.....
...........
...S.X.X.YW
...........
...P.......
...........
5