.........
.....P.L.
.........
.....X.X.
.........
..WX.X.X.
.........
...X.XW..
.........
.X.X.S...
.........
.Y.Y.Y...
...W.....
11