.......W...
.X.X.Y.Y...
...........
.Y.....Y...
...........
.P.L.X.G.X.
...........
.P.P.Y.X...
...........
12