.............
.....P.......
.............
.....X.......
.............
.....Y.......
.............
.Y.HWXWX.X.Y.
.............
.........X...
.............
.........L...
.............
7