...........
.....B.....
...........
.....H.....
...........
.....Y.....
...........
.....X.X.L.
...........
.P.X.Y.Y.X.
...........
.....Y.....
...........
8