...........
.....Y...Y.
...........
.G.GWSWPWY.
...........
.......X...
...........
.......Y...
.......W...
5