...............
.Y.Y.X.H.P.X.B.
...............
.......X.......
...............
.......X.......
...............
.......Y.......
...............
8