...............
...X.Y.X.X.P...
...............
...X...Y...X...
.......W.......
.B.X..WHW..X.Y.
.......W.......
...X.......X...
...............
...P.X.X.Y.X...
...............
12