.......W.
.P.X.X.P.
.........
.X.Y.Y.X.
...W.W...
.X.Y.Y.X.
.........
.P.X.X.P.
.W.......
10
