.............
...Y.........
.............
.............
.............
.YWX.X.L.X.X.
.............
...X.........
.............
...Y.X.H.....
.............
.....B.......
.............
10