...W.......
...X.X.X.YW
...........
...X.Y.....
.....W.....
...S.X.Y...
.....W.....
.G.P.X.....
...........
6