.............
.......Y.Y...
.............
.....Y.S.B...
.............
.....L.X.X.Y.
.............
.............
.............
.H...P.Y.X...
.............
10