...........
.L.X.X.Y.Y.
...........
.....S.....
...........
.....Y.....
...........
.....H.....
...........
5