.......W.......
.......Y.......
...............
...S...X.X...Y.
...............
.Y.B...X.X.....
...............
...Y...X.......
...............
...H...P.X.....
...............
8