...........
.........Y.
.........W.
.........Y.
...........
.........X.
...........
...X.....B.
...........
.Y.X.G.X.HW
.....W.....
...X.Y.....
...........
...P.......
...........
8