.......W.W.
.......Y.Y.
...........
.......X.P.
...........
WX.Y.X.P.PW
.........W.
...Y.......
...........
...P.......
...........
9
