...........
...P.......
...........
...P.......
...........
.X.P.X.X.B.
...........
...X.......
...........
...Y.......
...........
WX.X.YW....
...........
.Y.X.YW....
...W.......
8