.........
...Y.Y...
...W.....
.Y.G.G.Y.
.........
...Y.G.G.
.........
.......G.
.........
5