...........
...X.L.X.H.
...........
.....Y.....
...........
...X.Y.Y...
...........
...YWXWX...
...........
.P.L.X.X...
...........
9